46 57 46 56 45 56 45 55 44 55 44 54 43 54 43 53 42 53 42 52 41 52 41 51 41 50 40 50 40 49 39 49 39 48 38 48 38 47 37 47 37 46 36 46 36 45 35 45 35 44 35 43 34 43 34 42 33 42 33 41 32 41 32 40 31 40 31 39 30 39 30 38 30 37 29 37 29 36 28 36 28 35 27 35 27 34 26 34 26 33 25 33 25 32 24 32 24 31 24 30 23 30 23 29 22 29 22 28 21 28 21 27 20 27 20 26 19 26 19 25 19 24 18 24 18 23 17 23 17 22 16 22 16 21 15 21 15 20 14 20 14 19 14 18 13 18 13 17 12 17 12 16 11 16 11 15 10 15 10 14 9 14 9 13 8 13 8 12 8 11 7 11 7 10 6 10 6 9 5 9 5 8 4 8 4 7 3 7 3 6 3 5 2 5 2 4 1 4 1 3 0 3 0 2
33 49 33 50 33 51 33 52 33 53 33 54 33 55 33 56 33 57 33 58 33 59 33 60 33 61 33 62 33 63 33 64 33 65 33 66 33 67 33 68 33 69 33 70 33 71 33 72 33 73 33 74 33 75 33 76 33 77 33 78 33 79 33 80 33 81 33 82 33 83 33 84 33 85 33 86 33 87 33 88 33 89 33 90 33 91 33 92 33 93 33 94 33 95 33 96 33 97 33 98 33 99
38 89 39 89 39 88 40 88 41 88 41 87 42 87 42 86 43 86 44 86 44 85 45 85 46 85 46 84 47 84 48 84 48 83 49 83
1 8 0 8
1 30 2 30 2 31 3 31 3 32 4 32 4 33 5 33 5 34 6 34 6 35 7 35 7 36 8 36 8 37 9 37 9 38 10 38 10 39 11 39 11 40 12 40 12 41 13 41 13 42 14 42 14 43 15 43 15 44 16 44 16 45 17 45 17 46 18 46 18 47 19 47 20 47 20 48 21 48 21 49 22 49 22 50 23 50 23 51 24 51 24 52 25 52 25 53 26 53 26 54 27 54 27 55 28 55 28 56 29 56 29 57 30 57 30 58 31 58 31 59 32 59 32 60 33 60 33 61 34 61 34 62 35 62 35 63 36 63 36 64 37 64 38 64 38 65 39 65 39 66 40 66 40 67 41 67 41 68 42 68 42 69 43 69 43 70 44 70 44 71 45 71 45 72 46 72 46 73 47 73 47 74 48 74 48 75 49 75 49 76
24 96 23 96 22 96 21 96 21 95 20 95 19 95 18 95 17 95 16 95 16 94 15 94 14 94 13 94 12 94 11 94 11 93 10 93 9 93 8 93 7 93 6 93 6 92 5 92 4 92 3 92 2 92 1 92 1 91 0 91
14 38 14 39 14 40 14 41 15 41 15 42 15 43 15 44 15 45 15 46 15 47 16 47 16 48 16 49 16 50 16 51 16 52 17 52 17 53 17 54 17 55 17 56 17 57 17 58 18 58 18 59 18 60 18 61 18 62 18 63 18 64 19 64 19 65 19 66 19 67 19 68 19 69 19 70 20 70 20 71 20 72 20 73 20 74 20 75 21 75 21 76 21 77 21 78 21 79 21 80 21 81 22 81 22 82 22 83 22 84 22 85 22 86 22 87 23 87 23 88 23 89 23 90 23 91 23 92 23 93 24 93 24 94 24 95 24 96 24 97 24 98 24 99 25 99
7 61 7 60 8 60 8 59 8 58 9 58 9 57 10 57 10 56 10 55 11 55 11 54 11 53 12 53 12 52 13 52 13 51 13 50 14 50 14 49 14 48 15 48 15 47 16 47 16 46 16 45 17 45 17 44 17 43 18 43 18 42 19 42 19 41 19 40 20 40 20 39 20 38 21 38 21 37 22 37 22 36 22 35 23 35 23 34 23 33 24 33 24 32 24 31 25 31 25 30 26 30 26 29 26 28 27 28 27 27 27 26 28 26 28 25 29 25 29 24 29 23 30 23 30 22 30 21 31 21 31 20 32 20 32 19 32 18 33 18 33 17 33 16 34 16 34 15 35 15 35 14 35 13 36 13 36 12 36 11 37 11 37 10 38 10 38 9 38 8 39 8 39 7 39 6 40 6 40 5 41 5 41 4 41 3 42 3 42 2 42 1 43 1 43 0
1 53 0 53
19 58 19 57 18 57 18 56 18 55 17 55 17 54 16 54 16 53 16 52 15 52 15 51 15 50 14 50 14 49 13 49 13 48 13 47 12 47 12 46 12 45 11 45 11 44 11 43 10 43 10 42 9 42 9 41 9 40 8 40 8 39 8 38 7 38 7 37 6 37 6 36 6 35 5 35 5 34 5 33 4 33 4 32 3 32 3 31 3 30 2 30 2 29 2 28 1 28 1 27 1 26 0 26 0 25
40 6 40 7 41 7 41 8 41 9 42 9 42 10 42 11 43 11 43 12 43 13 44 13 44 14 44 15 45 15 45 16 45 17 46 17 46 18 47 18 47 19 47 20 48 20 48 21 48 22 49 22 49 23 49 24
10 21 10 22 9 22 9 23 8 23 8 24 7 24 7 25 7 26 6 26 6 27 5 27 5 28 4 28 4 29 4 30 3 30 3 31 2 31 2 32 1 32 1 33 1 34 0 34 0 35
15 20 15 21 16 21 16 22 16 23 16 24 17 24 17 25 17 26 17 27 18 27 18 28 18 29 18 30 19 30 19 31 19 32 19 33 20 33 20 34 20 35 20 36 21 36 21 37 21 38 21 39 22 39 22 40 22 41 23 41 23 42 23 43 23 44 24 44 24 45 24 46 24 47 25 47 25 48 25 49 25 50 26 50 26 51 26 52 26 53 27 53 27 54 27 55 27 56 28 56 28 57 28 58 29 58 29 59 29 60 29 61 30 61 30 62 30 63 30 64 31 64 31 65 31 66 31 67 32 67 32 68 32 69 32 70 33 70 33 71 33 72 33 73 34 73 34 74 34 75 34 76 35 76 35 77 35 78 36 78 36 79 36 80 36 81 37 81 37 82 37 83 37 84 38 84 38 85 38 86 38 87 39 87 39 88 39 89 39 90 40 90 40 91 40 92 40 93 41 93 41 94 41 95 42 95 42 96 42 97 42 98 43 98 43 99
35 73 35 74 35 75 34 75 34 76 34 77 34 78 34 79 34 80 33 80 33 81 33 82 33 83 33 84 33 85 32 85 32 86 32 87 32 88 32 89 31 89 31 90 31 91 31 92 31 93 31 94 30 94 30 95 30 96 30 97 30 98 29 98 29 99
2 69 3 69 4 69 4 70 5 70 6 70 7 70 7 71 8 71 9 71 10 71 10 72 11 72 12 72 13 72 13 73 14 73 15 73 16 73 16 74 17 74 18 74 19 74 19 75 20 75 21 75 22 75 23 75 23 76 24 76 25 76 26 76 26 77 27 77 28 77 29 77 29 78 30 78 31 78 32 78 32 79 33 79 34 79 35 79 35 80 36 80 37 80 38 80 38 81 39 81 40 81 41 81 42 81 42 82 43 82 44 82 45 82 45 83 46 83 47 83 48 83 48 84 49 84
43 22 42 22 42 23 41 23 40 23 40 24 39 24 38 24 38 25 37 25 36 25 36 26 35 26 34 26 34 27 33 27 33 28 32 28 31 28 31 29 30 29 29 29 29 30 28 30 27 30 27 31 26 31 25 31 25 32 24 32 23 32 23 33 22 33 21 33 21 34 20 34 19 34 19 35 18 35 17 35 17 36 16 36 16 37 15 37 14 37 14 38 13 38 12 38 12 39 11 39 10 39 10 40 9 40 8 40 8 41 7 41 6 41 6 42 5 42 4 42 4 43 3 43 2 43 2 44 1 44 0 44 0 45
0 98 0 97 0 96
19 52 20 52 20 53 21 53 22 53 22 54 23 54 24 54 24 55 25 55 25 56 26 56 27 56 27 57 28 57 29 57 29 58 30 58 31 58 31 59 32 59 33 59 33 60 34 60 35 60 35 61 36 61 37 61 37 62 38 62 38 63 39 63 40 63 40 64 41 64 42 64 42 65 43 65 44 65 44 66 45 66 46 66 46 67 47 67 48 67 48 68 49 68
48 62 48 61 48 60 47 60 47 59 47 58 47 57 46 57 46 56 46 55 46 54 45 54 45 53 45 52 45 51 44 51 44 50 44 49 44 48 43 48 43 47 43 46 43 45 43 44 42 44 42 43 42 42 42 41 41 41 41 40 41 39 41 38 40 38 40 37 40 36 40 35 39 35 39 34 39 33 39 32 38 32 38 31 38 30 38 29 38 28 37 28 37 27 37 26 37 25 36 25 36 24 36 23 36 22 35 22 35 21 35 20 35 19 34 19 34 18 34 17 34 16 33 16 33 15 33 14 33 13 33 12 32 12 32 11 32 10 32 9 31 9 31 8 31 7 31 6 30 6 30 5 30 4 30 3 29 3 29 2 29 1 29 0 28 0
7 68 6 68 6 67 5 67 5 66 4 66 3 66 3 65 2 65 1 65 1 64 0 64 0 63
