64 47 65 47 65 48 66 48 66 49 67 49 67 50 68 50 69 50 69 51 70 51 70 52 71 52 71 53 72 53 73 53 73 54 74 54 74 55 75 55 75 56 76 56 77 56 77 57 78 57 78 58 79 58 79 59 80 59 80 60 81 60 82 60 82 61 83 61 83 62 84 62 84 63 85 63 86 63 86 64 87 64 87 65 88 65 88 66 89 66 90 66 90 67 91 67 91 68 92 68 92 69 93 69 94 69 94 70 95 70 95 71 96 71 96 72 97 72 98 72 98 73 99 73 99 74
88 80 88 79 87 79 87 78 86 78 86 77 85 77 85 76 85 75 84 75 84 74 83 74 83 73 82 73 82 72 82 71 81 71 81 70 80 70 80 69 79 69 79 68 78 68 78 67 78 66 77 66 77 65 76 65 76 64 75 64 75 63 75 62 74 62 74 61 73 61 73 60 72 60 72 59 72 58 71 58 71 57 70 57 70 56 69 56 69 55 69 54 68 54 68 53 67 53 67 52 66 52 66 51 66 50 65 50 65 49 64 49 64 48 63 48 63 47 62 47 62 46 62 45 61 45 61 44 60 44 60 43 59 43 59 42 59 41 58 41 58 40 57 40 57 39 56 39 56 38 56 37 55 37 55 36 54 36 54 35 53 35 53 34 53 33 52 33 52 32 51 32 51 31 50 31 50 30 49 30 49 29 49 28 48 28 48 27 47 27 47 26 46 26 46 25 46 24 45 24 45 23 44 23 44 22 43 22 43 21 43 20 42 20 42 19 41 19 41 18 40 18 40 17 40 16 39 16 39 15 38 15 38 14 37 14 37 13 37 12 36 12 36 11 35 11 35 10 34 10 34 9 33 9 33 8 33 7 32 7 32 6 31 6 31 5 30 5 30 4 30 3 29 3 29 2 28 2 28 1 27 1 27 0
79 6 80 6 80 7 81 7 82 7 83 7 83 8 84 8 85 8 85 9 86 9 87 9 88 9 88 10 89 10 90 10 91 10 91 11 92 11 93 11 93 12 94 12 95 12 96 12 96 13 97 13 98 13 98 14 99 14
35 17 35 18 34 18 34 19 34 20 33 20 33 21 33 22 32 22 32 23 32 24 31 24 31 25 31 26 30 26 30 27 30 28 29 28 29 29 29 30 28 30 28 31 28 32 27 32 27 33 27 34 26 34 26 35 26 36 25 36 25 37 25 38 24 38 24 39 24 40 24 41 23 41 23 42 23 43 22 43 22 44 22 45 21 45 21 46 21 47 20 47 20 48 20 49 19 49 19 50 19 51 18 51 18 52 18 53 17 53 17 54 17 55 16 55 16 56 16 57 15 57 15 58 15 59 14 59 14 60 14 61 13 61 13 62 13 63 12 63 12 64 12 65 11 65 11 66 11 67 10 67 10 68 10 69 9 69 9 70 9 71 8 71 8 72 8 73 7 73 7 74 7 75 6 75 6 76 6 77 5 77 5 78 5 79 4 79 4 80 4 81 3 81 3 82 3 83 2 83 2 84 2 85 2 86 1 86 1 87 1 88 0 88 0 89 0 90
48 19 48 20 48 21 48 22 49 22 49 23 49 24 49 25 49 26 49 27 49 28 50 28 50 29 50 30 50 31 50 32 50 33 50 34 51 34 51 35 51 36 51 37 51 38 51 39 51 40 52 40 52 41 52 42 52 43 52 44 52 45 52 46 52 47 53 47 53 48 53 49 53 50 53 51 53 52 53 53 54 53 54 54 54 55 54 56 54 57 54 58 54 59 55 59 55 60 55 61 55 62 55 63 55 64 55 65 56 65 56 66 56 67 56 68 56 69 56 70 56 71 57 71 57 72 57 73 57 74 57 75 57 76 57 77 58 77 58 78 58 79 58 80 58 81 58 82 58 83 59 83 59 84 59 85 59 86 59 87 59 88 59 89 60 89 60 90 60 91 60 92 60 93 60 94 60 95 60 96 61 96 61 97 61 98 61 99
69 25 68 25 67 25 66 25 65 25 64 25 63 25 62 25 62 24 61 24 60 24 59 24 58 24 57 24 56 24 55 24 54 24 53 24 52 24 51 24 50 24 49 24 48 24 48 23 47 23 46 23 45 23 44 23 43 23 42 23 41 23 40 23 39 23 38 23 37 23 36 23 35 23 34 23 33 23 33 22 32 22 31 22 30 22 29 22 28 22 27 22 26 22 25 22 24 22 23 22 22 22 21 22 20 22 19 22 19 21 18 21 17 21 16 21 15 21 14 21 13 21 12 21 11 21 10 21 9 21 8 21 7 21 6 21 5 21 5 20 4 20 3 20 2 20 1 20 0 20
19 0
59 4 58 4 57 4 56 4 55 4 54 4 54 3 53 3 52 3 51 3 50 3 49 3 48 3 47 3 46 3 45 3 44 3 44 2 43 2 42 2 41 2 40 2 39 2 38 2 37 2 36 2 35 2 34 2 34 1 33 1 32 1 31 1 30 1 29 1 28 1 27 1 26 1 25 1 24 1 24 0 23 0 22 0 21 0 20 0 19 0 18 0 17 0 16 0 15 0 14 0
2 90 2 89 3 89 3 88 4 88 4 87 4 86 5 86 5 85 6 85 6 84 6 83 7 83 7 82 8 82 8 81 8 80 9 80 9 79 10 79 10 78 10 77 11 77 11 76 12 76 12 75 12 74 13 74 13 73 14 73 14 72 14 71 15 71 15 70 16 70 16 69 17 69 17 68 17 67 18 67 18 66 19 66 19 65 19 64 20 64 20 63 21 63 21 62 21 61 22 61 22 60 23 60 23 59 23 58 24 58 24 57 25 57 25 56 25 55 26 55 26 54 27 54 27 53 27 52 28 52 28 51 29 51 29 50 29 49 30 49 30 48 31 48 31 47 31 46 32 46 32 45 33 45 33 44 33 43 34 43 34 42 35 42 35 41 35 40 36 40 36 39 37 39 37 38 37 37 38 37 38 36 39 36 39 35 39 34 40 34 40 33 41 33 41 32 41 31 42 31 42 30 43 30 43 29 43 28 44 28 44 27 45 27 45 26 46 26 46 25 46 24 47 24 47 23 48 23 48 22 48 21 49 21 49 20 50 20 50 19 50 18 51 18 51 17 52 17 52 16 52 15 53 15 53 14 54 14 54 13 54 12 55 12 55 11 56 11 56 10 56 9 57 9 57 8 58 8 58 7 58 6 59 6 59 5 60 5 60 4 60 3 61 3 61 2 62 2 62 1 62 0 63 0
65 15 66 15 66 16 67 16 68 16 69 16 69 17 70 17 71 17 71 18 72 18 73 18 74 18 74 19 75 19 76 19 77 19 77 20 78 20 79 20 79 21 80 21 81 21 82 21 82 22 83 22 84 22 84 23 85 23 86 23 87 23 87 24 88 24 89 24 90 24 90 25 91 25 92 25 92 26 93 26 94 26 95 26 95 27 96 27 97 27 97 28 98 28 99 28
9 52 9 51 8 51 8 50 8 49 7 49 7 48 6 48 6 47 6 46 5 46 5 45 5 44 4 44 4 43 3 43 3 42 3 41 2 41 2 40 2 39 1 39 1 38 1 37 0 37 0 36
60 1 60 2 61 2 61 3 61 4 62 4 62 5 62 6 62 7 63 7 63 8 63 9 64 9 64 10 64 11 65 11 65 12 65 13 65 14 66 14 66 15 66 16 67 16 67 17 67 18 68 18 68 19 68 20 69 20 69 21 69 22 69 23 70 23 70 24 70 25 71 25 71 26 71 27 72 27 72 28 72 29 73 29 73 30 73 31 73 32 74 32 74 33 74 34 75 34 75 35 75 36 76 36 76 37 76 38 76 39 77 39 77 40 77 41 78 41 78 42 78 43 79 43 79 44 79 45 80 45 80 46 80 47 80 48 81 48 81 49 81 50 82 50 82 51 82 52 83 52 83 53 83 54 84 54 84 55 84 56 84 57 85 57 85 58 85 59 86 59 86 60 86 61 87 61 87 62 87 63 87 64 88 64 88 65 88 66 89 66 89 67 89 68 90 68 90 69 90 70 91 70 91 71 91 72 91 73 92 73 92 74 92 75 93 75 93 76 93 77 94 77 94 78 94 79 95 79 95 80 95 81 95 82 96 82 96 83 96 84 97 84 97 85 97 86 98 86 98 87 98 88 98 89 99 89 99 90 99 91
58 14 58 13 58 12 59 12 59 11 59 10 59 9 59 8 60 8 60 7 60 6 60 5 60 4 60 3 61 3 61 2 61 1 61 0
26 81 26 82 26 83 25 83 25 84 25 85 25 86 25 87 24 87 24 88 24 89 24 90 24 91 24 92 23 92 23 93 23 94 23 95 23 96 22 96 22 97 22 98 22 99
52 68 51 68 51 67 50 67 50 66 49 66 49 65 48 65 48 64 47 64 47 63 46 63 46 62 45 62 45 61 44 61 43 61 43 60 42 60 42 59 41 59 41 58 40 58 40 57 39 57 39 56 38 56 38 55 37 55 37 54 36 54 36 53 35 53 34 53 34 52 33 52 33 51 32 51 32 50 31 50 31 49 30 49 30 48 29 48 29 47 28 47 28 46 27 46 26 46 26 45 25 45 25 44 24 44 24 43 23 43 23 42 22 42 22 41 21 41 21 40 20 40 20 39 19 39 19 38 18 38 17 38 17 37 16 37 16 36 15 36 15 35 14 35 14 34 13 34 13 33 12 33 12 32 11 32 11 31 10 31 9 31 9 30 8 30 8 29 7 29 7 28 6 28 6 27 5 27 5 26 4 26 4 25 3 25 3 24 2 24 2 23 1 23 0 23 0 22
27 31 28 31 28 32 29 32 30 32 31 32 31 33 32 33 33 33 33 34 34 34 35 34 36 34 36 35 37 35 38 35 38 36 39 36 40 36 41 36 41 37 42 37 43 37 43 38 44 38 45 38 46 38 46 39 47 39 48 39 48 40 49 40 50 40 51 40 51 41 52 41 53 41 53 42 54 42 55 42 56 42 56 43 57 43 58 43 58 44 59 44 60 44 61 44 61 45 62 45 63 45 63 46 64 46 65 46 66 46 66 47 67 47 68 47 68 48 69 48 70 48 71 48 71 49 72 49 73 49 73 50 74 50 75 50 75 51 76 51 77 51 78 51 78 52 79 52 80 52 80 53 81 53 82 53 83 53 83 54 84 54 85 54 85 55 86 55 87 55 88 55 88 56 89 56 90 56 90 57 91 57 92 57 93 57 93 58 94 58 95 58 95 59 96 59 97 59 98 59 98 60 99 60
81 4 81 3 82 3 82 2 83 2 83 1 83 0 84 0
5 17 6 17 6 16 7 16 8 16 9 16 9 15 10 15 11 15 11 14 12 14 13 14 14 14 14 13 15 13 16 13 16 12 17 12 18 12 19 12 19 11 20 11 21 11 21 10 22 10 23 10 24 10 24 9 25 9 26 9 26 8 27 8 28 8 29 8 29 7 30 7 31 7 31 6 32 6 33 6 34 6 34 5 35 5 36 5 36 4 37 4 38 4 39 4 39 3 40 3 41 3 41 2 42 2 43 2 44 2 44 1 45 1 46 1 46 0 47 0 48 0 49 0
50 21 51 21 51 20 52 20 52 19 53 19 53 18 54 18 54 17 55 17 55 16 56 16 56 15 57 15 57 14 58 14 59 14 59 13 60 13 60 12 61 12 61 11 62 11 62 10 63 10 63 9 64 9 64 8 65 8 65 7 66 7 66 6 67 6 68 6 68 5 69 5 69 4 70 4 70 3 71 3 71 2 72 2 72 1 73 1 73 0 74 0
0 80
80 97 80 96 79 96 79 95 79 94 78 94 78 93 78 92 78 91 77 91 77 90 77 89 76 89 76 88 76 87 75 87 75 86 75 85 74 85 74 84 74 83 74 82 73 82 73 81 73 80 72 80 72 79 72 78 71 78 71 77 71 76 70 76 70 75 70 74 70 73 69 73 69 72 69 71 68 71 68 70 68 69 67 69 67 68 67 67 66 67 66 66 66 65 66 64 65 64 65 63 65 62 64 62 64 61 64 60 63 60 63 59 63 58 62 58 62 57 62 56 62 55 61 55 61 54 61 53 60 53 60 52 60 51 59 51 59 50 59 49 58 49 58 48 58 47 57 47 57 46 57 45 57 44 56 44 56 43 56 42 55 42 55 41 55 40 54 40 54 39 54 38 53 38 53 37 53 36 53 35 52 35 52 34 52 33 51 33 51 32 51 31 50 31 50 30 50 29 49 29 49 28 49 27 49 26 48 26 48 25 48 24 47 24 47 23 47 22 46 22 46 21 46 20 45 20 45 19 45 18 45 17 44 17 44 16 44 15 43 15 43 14 43 13 42 13 42 12 42 11 41 11 41 10 41 9 41 8 40 8 40 7 40 6 39 6 39 5 39 4 38 4 38 3 38 2 37 2 37 1 37 0
84 81 84 82 84 83 83 83 83 84 83 85 83 86 82 86 82 87 82 88 82 89 81 89 81 90 81 91 81 92 80 92 80 93 80 94 80 95 79 95 79 96 79 97 79 98 78 98 78 99
28 12 27 12 26 12 25 12 24 12 24 11 23 11 22 11 21 11 20 11 19 11 18 11 17 11 16 11 16 10 15 10 14 10 13 10 12 10 11 10 10 10 9 10 9 9 8 9 7 9 6 9 5 9 4 9 3 9 2 9 1 9 1 8 0 8
0 82 1 82 1 83 2 83 3 83 3 84 4 84 5 84 5 85 6 85 7 85 7 86 8 86 9 86 9 87 10 87 11 87 11 88 12 88 13 88 13 89 14 89 15 89 15 90 16 90 17 90 17 91 18 91 19 91 19 92 20 92 21 92 21 93 22 93 23 93 23 94 24 94 25 94 25 95 26 95 27 95 27 96 28 96 29 96 29 97 30 97 31 97 31 98 32 98 33 98 33 99 34 99 35 99
60 72 59 72 59 71 58 71 57 71 56 71 56 70 55 70 54 70 53 70 53 69 52 69 51 69 51 68 50 68 49 68 48 68 48 67 47 67 46 67 45 67 45 66 44 66 43 66 43 65 42 65 41 65 40 65 40 64 39 64 38 64 37 64 37 63 36 63 35 63 34 63 34 62 33 62 32 62 32 61 31 61 30 61 29 61 29 60 28 60 27 60 26 60 26 59 25 59 24 59 24 58 23 58 22 58 21 58 21 57 20 57 19 57 18 57 18 56 17 56 16 56 16 55 15 55 14 55 13 55 13 54 12 54 11 54 10 54 10 53 9 53 8 53 8 52 7 52 6 52 5 52 5 51 4 51 3 51 2 51 2 50 1 50 0 50 0 49
37 10 36 10 36 11 35 11 35 12 34 12 34 13 33 13 33 14 32 14 32 15 31 15 31 16 30 16 30 17 29 17 29 18 28 18 27 18 27 19 26 19 26 20 25 20 25 21 24 21 24 22 23 22 23 23 22 23 22 24 21 24 21 25 20 25 20 26 19 26 19 27 18 27 17 27 17 28 16 28 16 29 15 29 15 30 14 30 14 31 13 31 13 32 12 32 12 33 11 33 11 34 10 34 10 35 9 35 8 35 8 36 7 36 7 37 6 37 6 38 5 38 5 39 4 39 4 40 3 40 3 41 2 41 2 42 1 42 1 43 0 43 0 44
5 50 5 49 6 49 6 48 7 48 7 47 8 47 8 46 8 45 9 45 9 44 10 44 10 43 11 43 11 42 12 42 12 41 12 40 13 40 13 39 14 39 14 38 15 38 15 37 15 36 16 36 16 35 17 35 17 34 18 34 18 33 19 33 19 32 19 31 20 31 20 30 21 30 21 29 22 29 22 28 22 27 23 27 23 26 24 26 24 25 25 25 25 24 25 23 26 23 26 22 27 22 27 21 28 21 28 20 29 20 29 19 29 18 30 18 30 17 31 17 31 16 32 16 32 15 32 14 33 14 33 13 34 13 34 12 35 12 35 11 35 10 36 11 36 10 36 9 37 9 37 8 38 8 38 7 39 7 39 6 39 5 40 5 40 4 41 4 41 3 42 3 42 2 42 1 43 1 43 0 44 0
33 35 32 35 32 34 31 34 30 34 29 34 29 33 28 33 27 33 26 33 26 32 25 32 24 32 23 32 23 31 22 31 21 31 20 31 20 30 19 30 18 30 17 30 17 29 16 29 15 29 14 29 14 28 13 28 12 28 11 28 11 27 10 27 9 27 9 26 8 26 7 26 6 26 6 25 5 25 4 25 3 25 3 24 2 24 1 24 0 24 0 23
17 2 17 1 18 1 18 0
82 23 82 22 82 21 82 20 81 20 81 19 81 18 81 17 81 16 81 15 81 14 81 13 80 13 80 12 80 11 80 10 80 9 80 8 80 7 80 6 79 7 79 6 79 5 79 4 79 3 79 2 79 1 79 0 78 0
0 7 1 7 1 8 2 8 2 9 3 9 4 9 4 10 5 10 6 10 6 11 7 11 7 12 8 12 9 12 9 13 10 13 11 13 10 14 11 14 12 14 12 15 13 15 14 15 14 16 15 16 15 17 16 17 17 17 17 18 18 18 19 18 19 19 20 19 20 20 21 20 22 20 22 21 23 21 23 22 24 22 25 22 25 23 26 23 27 23 27 24 28 24 28 25 29 25 30 25 30 26 31 26 32 26 31 27 32 27 33 27 33 28 34 28 35 28 35 29 36 29 36 30 37 30 38 30 38 31 39 31 40 31 40 32 41 32 41 33 42 33 43 33 43 34 44 34 44 35 45 35 46 35 46 36 47 36 48 36 48 37 49 37 49 38 50 38 51 38 51 39 52 39 53 39 52 40 53 40 54 40 54 41 55 41 56 41 56 42 57 42 57 43 58 43 59 43 59 44 60 44 61 44 61 45 62 45 62 46 63 46 64 46 64 47 65 47 65 48 66 48 67 48 67 49 68 49 69 49 69 50 70 50 70 51 71 51 72 51 72 52 73 52 74 52 73 53 74 53 75 53 75 54 76 54 77 54 77 55 78 55 78 56 79 56 80 56 80 57 81 57 82 57 82 58 83 58 83 59 84 59 85 59 85 60 86 60 86 61 87 61 88 61 88 62 89 62 90 62 90 63 91 63 91 64 92 64 93 64 93 65 94 65 95 65 94 66 95 66 96 66 96 67 97 67 98 67 98 68 99 68 99 69
40 19 40 20 41 20 41 21 41 22 42 22 42 23 42 24 43 24 43 25 43 26 44 26 44 27 44 28 45 28 45 29 45 30 46 30 46 31 46 32 47 32 47 33 47 34 48 34 48 35 48 36 49 36 49 37 49 38 50 38 50 39 50 40 51 40 51 41 52 41 52 42 52 43 53 43 53 44 53 45 54 45 54 46 54 47 55 47 55 48 55 49 56 49 56 50 56 51 57 51 57 52 57 53 58 53 58 54 58 55 59 55 59 56 59 57 60 57 60 58 60 59 61 59 61 60 61 61 62 61 62 62 62 63 63 63 63 64 63 65 64 65 64 66 64 67 65 67 65 68 65 69 66 69 66 70 66 71 67 71 67 72 67 73 68 73 68 74 68 75 69 75 69 76 69 77 70 77 70 78 70 79 71 79 71 80 71 81 72 81 72 82 72 83 73 83 73 84 73 85 74 85 74 86 75 86 75 87 75 88 76 88 76 89 76 90 77 90 77 91 77 92 78 92 78 93 78 94 79 94 79 95 79 96 80 96 80 97 80 98 81 98 81 99
50 21 50 22 50 23 50 24 51 24 51 25 51 26 51 27 51 28 51 29 51 30 51 31 52 31 52 32 52 33 52 34 52 35 52 36 52 37 53 37 53 38 53 39 53 40 53 41 53 42 53 43 53 44 54 44 54 45 54 46 54 47 54 48 54 49 54 50 55 50 55 51 55 52 55 53 55 54 55 55 55 56 55 57 56 57 56 58 56 59 56 60 56 61 56 62 56 63 57 63 57 64 57 65 57 66 57 67 57 68 57 69 57 70 58 70 58 71 58 72 58 73 58 74 58 75 58 76 58 77 59 77 59 78 59 79 59 80 59 81 59 82 59 83 60 83 60 84 60 85 60 86 60 87 60 88 60 89 60 90 61 90 61 91 61 92 61 93 61 94 61 95 61 96 62 96 62 97 62 98 62 99
56 58 56 57 57 57 57 56 57 55 57 54 58 54 58 53 58 52 59 52 59 51 59 50 59 49 60 49 60 48 60 47 61 47 61 46 61 45 61 44 62 44 62 43 62 42 63 42 63 41 63 40 63 39 64 39 64 38 64 37 65 37 65 36 65 35 65 34 66 34 66 33 66 32 67 32 67 31 67 30 67 29 68 29 68 28 68 27 69 27 69 26 69 25 69 24 70 24 70 23 70 22 71 22 71 21 71 20 71 19 72 19 72 18 72 17 73 17 73 16 73 15 73 14 74 14 74 13 74 12 74 11 75 12 75 11 75 10 75 9 76 9 76 8 76 7 76 6 77 6 77 5 77 4 78 4 78 3 78 2 78 1 79 1 79 0
15 14 14 14 13 14 12 14 12 15 11 15 10 15 9 15 8 15 7 15 7 16 6 16 5 16 4 16 3 16 2 16 2 17 1 17 0 17
56 72 56 71 56 70 56 69 56 68 56 67 56 66 56 65 56 64 56 63 56 62 56 61 56 60 56 59 56 58 56 57 56 56 56 55 57 55 57 54 57 53 57 52 57 51 57 50 57 49 57 48 57 47 57 46 57 45 57 44 57 43 57 42 57 41 57 40 57 39 57 38 57 37 57 36 57 35 57 34 57 33 57 32 57 31 57 30 57 29 57 28 57 27 57 26 57 25 57 24 57 23 57 22 58 22 58 21 58 20 58 19 58 18 58 17 58 16 58 15 58 14 58 13 58 12 58 11 58 10 58 9 58 8 58 7 58 6 58 5 58 4 58 3 58 2 58 1 58 0
8 82 8 81 8 80 8 79 8 78 8 77 8 76 8 75 8 74 8 73 8 72 8 71 8 70 8 69 8 68 8 67 8 66 8 65 8 64 8 63 8 62 8 61 8 60 8 59 8 58 8 57 8 56 8 55 8 54 8 53 8 52 8 51 8 50 8 49 8 48 8 47 8 46 8 45 8 44 8 43 8 42 8 41 8 40 8 39 8 38 8 37 8 36 8 35 8 34 8 33 8 32 9 32 9 31 9 30 9 29 9 28 9 27 9 26 9 25 9 24 9 23 9 22 9 21 9 20 9 19 9 18 9 17 9 16 9 15 9 14 9 13 9 12 9 11 9 10 9 9 9 8 9 7 9 6 9 5 9 4 9 3 9 2 9 1 9 0
43 94 44 94 45 94 46 94 46 95 47 95 48 95 49 95 50 95 51 95 52 95 52 96 53 96 54 96 55 96 56 96 57 96 57 97 58 97 59 97 60 97 61 97 62 97 63 97 63 98 64 98 65 98 66 98 67 98 68 98 69 98 69 99 70 99 71 99 72 99 73 99 74 99 75 99
87 16 88 16 88 17 89 17 90 17 90 18 91 18 92 18 92 19 93 19 94 19 94 20 95 20 96 20 96 21 97 21 98 21 98 22 99 22
73 31 73 30 73 29 73 28 72 28 72 27 72 26 72 25 72 24 72 23 72 22 72 21 71 21 71 20 71 19 71 18 71 17 71 16 71 15 71 14 70 15 70 14 70 13 70 12 70 11 70 10 70 9 70 8 69 8 69 7 69 6 69 5 69 4 69 3 69 2 69 1 68 1 68 0
1 79 1 80 0 80 0 81
92 5 92 6 92 7 93 7 93 8 93 9 93 10 93 11 93 12 94 12 94 13 94 14 94 15 94 16 94 17 95 17 95 18 95 19 95 20 95 21 95 22 96 22 96 23 96 24 96 25 96 26 96 27 97 27 97 28 97 29 97 30 97 31 97 32 98 32 98 33 98 34 98 35 98 36 98 37 99 37 99 38 99 39 99 40 99 41
62 17 62 16 62 15 63 15 63 14 63 13 63 12 64 12 64 11 64 10 64 9 65 9 65 8 65 7 65 6 66 6 66 5 66 4 66 3 67 3 67 2 67 1 67 0
70 25 70 26 70 27 69 27 69 28 69 29 69 30 69 31 68 31 68 32 68 33 68 34 68 35 67 35 67 36 67 37 67 38 67 39 66 39 66 40 66 41 66 42 66 43 65 43 65 44 65 45 65 46 65 47 64 47 64 48 64 49 64 50 64 51 63 51 63 52 63 53 63 54 63 55 62 55 62 56 62 57 62 58 62 59 61 59 61 60 61 61 61 62 61 63 60 63 60 64 60 65 60 66 60 67 59 67 59 68 59 69 59 70 59 71 58 71 58 72 58 73 58 74 58 75 58 76 57 76 57 77 57 78 57 79 57 80 56 80 56 81 56 82 56 83 56 84 55 84 55 85 55 86 55 87 55 88 54 88 54 89 54 90 54 91 54 92 53 92 53 93 53 94 53 95 53 96 52 96 52 97 52 98 52 99
35 5 34 5 33 5 32 5 31 5 30 5 29 5 28 5 28 6 27 6 26 6 25 6 24 6 23 6 22 6 21 6 20 6 19 6 18 6 17 6 16 6 15 6 14 6 14 7 13 7 12 7 11 7 10 7 9 7 8 7 7 7 6 7 5 7 4 7 3 7 2 7 1 7 0 7
93 4 92 4 91 4 90 4 89 4 88 4 87 4 86 4 85 4 84 4 83 4 82 4 81 4 80 4 79 4 78 4 77 4 76 4 76 3 75 3 74 3 73 3 72 3 71 3 70 3 69 3 68 3 67 3 66 3 65 3 64 3 63 3 62 3 61 3 60 3 59 3 58 3 57 3 56 3 55 3 54 3 53 3 52 3 51 3 50 3 49 3 48 3 47 3 46 3 45 3 44 3 43 3 43 2 42 2 41 2 40 2 39 2 38 2 37 2 36 2 35 2 34 2 33 2 32 2 31 2 30 2 29 2 28 2 27 2 26 2 25 2 24 2 23 2 22 2 21 2 20 2 19 2 18 2 17 2 16 2 15 2 14 2 13 2 12 2 11 2 10 2 10 1 9 1 8 1 7 1 6 1 5 1 4 1 3 1 2 1 1 1 0 1
36 42 36 41 36 40 36 39 36 38 36 37 36 36 36 35 36 34 36 33 36 32 36 31 36 30 36 29 36 28 36 27 36 26 36 25 36 24 36 23 36 22 36 21 36 20 36 19 36 18 36 17 36 16 36 15 36 14 36 13 36 12 36 11 36 10 36 9 36 8 36 7 36 6 36 5 36 4 36 3 36 2 36 1 36 0
46 38 46 39 46 40 47 40 47 41 47 42 47 43 47 44 47 45 48 45 48 46 48 47 48 48 48 49 48 50 49 50 49 51 49 52 49 53 49 54 50 54 50 55 50 56 50 57 50 58 50 59 51 59 51 60 51 61 51 62 51 63 52 63 52 64 52 65 52 66 52 67 52 68 53 68 53 69 53 70 53 71 53 72 53 73 54 73 54 74 54 75 54 76 54 77 55 77 55 78 55 79 55 80 55 81 55 82 56 82 56 83 56 84 56 85 56 86 56 87 57 86 57 87 57 88 57 89 57 90 57 91 58 91 58 92 58 93 58 94 58 95 58 96 59 96 59 97 59 98 59 99
79 80 78 80 77 80 77 79 76 79 75 79 74 79 73 79 72 79 72 78 71 78 70 78 69 78 68 78 67 78 67 77 66 77 65 77 64 77 63 77 62 77 62 76 61 76 60 76 59 76 58 76 57 76 57 75 56 75 55 75 54 75 53 75 52 75 52 74 51 74 50 74 49 74 48 74 47 74 47 73 46 73 45 73 44 73 43 73 42 73 42 72 41 72 40 72 39 72 38 72 37 72 37 71 36 71 35 71 34 71 33 71 32 71 32 70 31 70 30 70 29 70 28 70 27 70 27 69 26 69 25 69 24 69 23 69 22 69 22 68 21 68 20 68 19 68 18 68 17 68 17 67 16 67 15 67 14 67 13 67 12 67 12 66 11 66 10 66 9 66 8 66 7 66 7 65 6 65 5 65 4 65 3 65 2 65 2 64 1 64 0 64
85 13 84 13 84 12 83 12 82 12 82 11 81 11 80 11 80 10 79 10 78 10 78 9 77 9 76 9 76 8 75 8 74 8 74 7 73 7 72 7 72 6 71 6 70 6 70 5 69 5 68 5 68 4 67 4 66 4 66 3 65 3 64 3 64 2 63 2 62 2 62 1 61 1 60 1 60 0 59 0 58 0
